3 28 3979 1395 7023 7057 5681 2807 7134 7156 3721 7233 2798 7281 4272 7322 1182 2587 3449 7485 4273 1296 7617 7654 7685 7709 7736 7770 7800 5497 
1 2 1341 2807 
1 4 6832 769 6858 6893 
3 7 1395 5087 6948 1935 6880 5703 6858 
2 6 769 2507 701 2403 6736 6690 
1 19 6690 2159 6664 5426 6630 3553 3778 508 5658 3304 6502 5220 6482 3516 2098 6499 6514 6531 2391 
1 7 2159 6672 5126 6642 6622 6605 3805 
1 8 6880 6861 5382 275 4265 5427 2962 6731 
1 3 5427 6793 6826 
2 7 6826 5042 5844 2340 6937 4133 1395 
2 32 5042 1073 3626 4988 6903 5146 3723 6918 4926 6935 3021 6964 6970 1838 6887 2549 1459 6805 1805 1256 6730 6722 6715 6688 1332 1849 6677 4788 2768 6683 15 6731 
2 27 1838 2993 1124 659 7002 4816 7030 7018 7026 7045 2816 7098 7121 2347 7155 2508 7172 4128 4996 5945 3011 7249 7195 1141 7123 461 5205 
1 5 6715 1320 5919 6759 3385 
1 5 4988 5298 4520 6806 3385 
1 4 5290 4607 7278 7318 
1 2 7156 5290 
1 17 5681 5165 7050 4776 7040 7039 7053 7072 5125 7113 3428 7141 7153 7165 3250 3404 2141 
1 30 2141 7343 4552 5256 2910 7460 3694 4221 7554 2237 7599 7604 4699 7684 7701 2175 7745 4453 1315 30 5680 1379 7881 2147 7942 2351 2980 8040 43 4127 
1 5 2141 7300 7301 2567 7258 
2 4 7258 3077 7270 7281 
1 6 5145 4884 3990 4827 6562 2391 
2 10 1849 2963 5417 1316 6594 5076 6539 6550 6568 3805 
1 2 4788 5417 
1 6 5125 2232 3981 7142 3508 3721 
1 6 7040 3948 6983 6962 6931 6903 
1 10 4926 6961 1526 7016 3029 5015 1097 565 4539 7165 
2 75 5015 2017 4644 2629 564 1883 4863 7250 7277 1423 2650 5605 7369 5705 5767 5522 2125 1011 5420 3798 251 5374 7452 1025 7435 1602 779 5729 5384 4419 7541 1752 4573 7586 7614 7641 3409 7731 3394 2826 7826 1917 7865 7882 5377 2651 7949 2765 7996 5776 8063 5808 8151 5452 4662 1258 8233 5188 8287 8305 3757 3315 8361 8389 2827 4661 8422 5967 4172 3601 55 8482 5956 8496 3906 
1 11 3232 6916 6945 3491 6977 6986 6999 4771 3079 1650 7045 
1 11 3079 3701 4992 7071 3057 4750 5094 7107 7127 7146 7172 
1 17 4992 2687 7098 7108 837 7164 5046 4740 2629 4167 7182 5228 1229 7274 7296 3142 2141 
2 9 4996 7222 7229 4241 3441 7225 5309 1861 2650 
1 8 7590 7584 1190 2787 7560 5173 2012 7461 
2 6 4694 179 7469 7461 7467 3449 
1 5 1874 2111 4159 4869 7709 
1 10 7604 5063 7600 184 7630 7658 7669 3729 526 7685 
2 7 5497 7837 5625 7872 7897 2771 7952 
2 5 2771 7961 7984 8034 2255 
2 21 5494 1104 8310 5192 4645 3578 8273 5170 8257 4142 8247 5592 3109 8250 1890 8266 5134 1030 1448 984 3526 
2 15 5877 1537 5248 4822 4306 8199 8224 8245 4667 8330 5737 3488 8373 4239 8409 
2 4 3488 4131 5747 8427 
1 14 8427 3733 3476 8472 581 8495 3964 8473 527 8459 4397 4191 5009 4845 
2 3 8330 8341 4845 
1 8 8224 8244 8260 8282 1066 149 8267 984 
1 10 3526 8191 8165 1286 8112 2226 8073 5877 3947 8034 
1 4 5497 3208 5647 1315 
1 9 4273 7517 287 1250 358 2552 7419 7391 4552 
1 16 5220 4418 6490 3186 925 2981 2584 6436 5699 1067 6474 2187 373 5519 1519 6550 
2 28 8359 2132 5494 3552 4061 5250 8230 796 8207 3547 3660 8131 8111 253 1923 5449 2640 7978 5811 7938 7920 3235 4738 346 2113 7903 4989 2147 
1 5 2351 4731 4345 8014 3947 
1 7 4127 8078 5441 8103 3202 5854 5449 
2 33 5605 7383 5913 7500 4890 2712 4799 3129 584 7668 2884 7724 4407 7772 4398 7830 7847 4007 1281 1451 4737 2018 4981 8005 8022 8052 684 3462 8108 5084 863 8190 796 
1 4 8191 8177 607 539 
1 16 3109 8204 2558 1504 539 8078 2311 4086 5521 7957 346 5311 3213 4287 1000 7806 
1 5 5170 5381 8203 2864 3547 
1 14 7847 5168 7871 4069 2753 7936 7938 2773 5853 5797 7812 5337 3300 4407 
1 12 7871 7906 7937 7960 7994 8017 5271 8047 4408 8085 8077 3462 
1 13 3129 1437 7672 1994 5376 7718 5914 1304 2231 7828 5853 5468 4738 
1 6 5914 7755 7768 7760 3515 7701 
1 4 7500 7519 3493 7554 
1 15 5256 7403 7390 7395 4670 4795 3754 7277 4589 4817 7262 1229 7232 2543 3250 
1 4 7225 4451 7191 7164 
1 11 6630 5472 6589 3822 6552 6530 6511 6489 4429 1856 2981 
1 4 373 6559 3062 6511 
1 2 4239 4131 
1 4 8282 8319 8344 4239 
1 12 8361 1551 3421 4579 8358 1648 8372 8370 8354 2487 8367 5494 
2 36 2487 1059 8318 5570 4787 8238 2341 2039 47 428 8080 3051 8004 2872 3562 7904 3072 7866 1002 7831 4986 3693 7739 4711 7676 2157 7615 4291 3711 214 7545 4231 4498 5939 7444 2125 
1 9 2341 5098 3518 4630 5938 8183 2824 5634 8189 
2 28 8189 8188 4640 5452 3883 8185 4242 5017 8202 2460 2109 5964 3346 3869 8209 2911 8138 1957 3724 132 8062 1351 3898 8061 5024 4570 8008 7986 
1 3 8389 2909 8422 
1 3 8185 4662 3883 
1 29 2109 4050 8297 4990 1205 3709 8385 1449 5117 1511 4586 3706 1859 8432 8428 8410 3184 5828 4107 8308 8268 2724 2070 8195 231 5834 3370 360 8061 
1 5 428 8090 684 5803 8077 
1 10 2872 3893 3052 2933 7918 7934 3107 7912 7891 1917 
3 26 4546 2751 4963 8041 2783 7997 2416 7966 467 7884 1142 1278 2344 7791 3321 5365 7706 4955 2362 5649 5541 5085 4106 7459 7426 2244 
3 17 2836 6959 6928 6881 6843 2384 6812 5899 3608 6738 6732 6710 6692 6673 4089 5202 6597 
2 12 2244 7362 933 4678 1912 7231 7201 1268 1760 1810 7036 2836 
2 10 7231 3489 868 969 5 2312 881 7547 1880 5541 
2 54 4106 7522 7513 726 4036 7437 4134 705 7430 1466 7434 7449 2308 4160 7483 2785 499 4854 7414 4663 1479 2725 7450 4283 3672 7405 2870 7409 654 7410 1412 3117 3266 7531 7515 4093 7525 7555 2630 7583 1581 4933 5896 7569 5409 7621 3075 4665 1785 5352 7691 1679 1887 3409 
2 9 8041 8023 2048 7967 7923 2419 7890 5330 1142 
1 29 7923 5358 1365 4836 3078 2875 5023 7801 7789 5873 2821 2747 7808 5280 2476 432 4352 2903 970 7779 7753 1407 7687 639 2595 2433 3602 7620 7583 
2 30 7753 1413 3785 4930 2126 7924 1657 7986 2349 4741 3104 3504 8106 1400 4409 8075 5448 727 8117 2726 8159 711 140 1699 8184 8145 3354 8123 5007 2751 
2 6 8184 2662 5368 8179 5818 4546 
2 18 3577 5507 2163 4730 7110 7097 7109 520 7161 1920 5742 3917 7319 3442 1479 1113 1215 4848 
1 7 4848 7585 2602 2423 3216 1457 5873 
1 11 726 4523 3565 7636 2394 7727 1373 7764 7807 5655 2875 
2 12 6732 3094 1769 6763 6785 130 3225 495 6758 6746 3058 6716 
3 37 6716 5869 6756 4722 6771 923 4032 2445 6833 2160 1597 6950 5650 7024 3288 2024 2564 423 7197 7202 7175 3629 4714 1956 1833 7104 2467 2621 4839 7046 3988 2303 1993 1114 7082 2409 7128 
1 23 4032 2373 142 6725 3308 2257 2619 6735 3091 6718 6717 4504 6741 5893 1027 1562 6910 1550 5790 1078 5154 3926 2409 
1 18 2621 2533 1321 6949 4828 1562 6828 4454 1299 137 2471 634 4621 6755 3606 6743 2246 1297 
3 13 1297 2094 3962 101 3782 6968 4325 4768 7009 100 7047 5247 3926 
2 21 2471 1628 6821 1925 6862 4067 6889 731 6966 4768 2088 4432 7032 7048 7055 3317 2723 7066 7085 462 5891 
1 6 137 6711 5083 1501 3774 6741 
1 8 5650 706 3720 3314 6892 4842 1387 4334 
1 23 2276 6404 1563 3089 661 6492 972 6572 3380 6653 4169 6718 6752 612 979 2819 4334 4882 1477 7013 4587 7079 7104 
1 10 7202 192 2204 4136 1249 2494 7394 2844 7480 7515 
3 16 1785 313 2711 4474 4943 4354 7393 152 4541 7307 7267 7228 5787 7180 5312 7128 
2 18 5787 446 3833 5401 3843 5071 430 4228 7341 2823 7407 7464 4427 779 3061 2749 7556 2636 
2 5 4228 1417 7234 7177 5049 
2 21 1141 5447 7159 5891 7151 7143 5049 5388 4872 7055 4364 7000 6975 5881 6943 6925 5244 3782 5511 5047 4067 
2 17 5447 7190 4923 7286 1711 7336 1789 1214 7429 7452 7402 1362 5771 7285 7252 1312 5891 
2 4 1789 2793 5288 5420 
2 6 5945 7264 5195 5667 7360 5767 
2 3 2125 3417 5667 
2 2 1141 7190 
1 9 2636 5442 2157 3211 7700 3655 7767 947 1281 
1 8 4573 7528 4624 7505 7481 5178 2944 152 
1 17 5384 7587 4867 5848 3561 7717 3408 3650 7780 2456 7840 2076 7918 3645 3259 1018 4079 
1 9 3577 7005 6972 3151 6897 4176 6798 2254 6746 
1 10 6833 6853 1635 5004 1969 1818 1047 7063 7088 7109 
1 10 3442 7371 7333 1298 3985 2411 310 5805 7189 423 
1 7 1511 8441 8445 3505 2133 3940 3601 
1 13 4990 5436 3914 5724 5188 2498 5829 8269 4342 8280 4557 5379 8358 
1 3 8268 8241 8209 
1 14 7996 8003 2767 7990 5299 4703 3631 1633 7954 7956 4612 8009 1965 3724 
1 13 3672 2893 7540 7568 2927 967 2477 7659 5387 7687 3617 3356 3266 
1 13 2433 7660 5011 1512 7737 7761 7765 2525 229 4227 2829 2034 4612 
1 8 7954 3545 284 2511 2064 2569 2759 5352 
1 6 2759 7790 4295 4346 1809 7882 
1 13 4943 7463 5285 7377 7367 7346 4673 4484 4103 7227 7242 2327 1956 
1 14 2836 817 4105 4146 7003 1846 6982 6960 1705 457 4938 6888 6902 3151 
1 9 7449 240 5484 440 7284 4047 4188 5520 4730 
1 9 7437 273 5596 1940 7288 7241 1707 7196 1268 
1 11 5448 8050 8035 5153 8001 7982 5372 1331 7894 3573 2875 
1 6 8050 2888 4535 3070 2468 2476 
1 14 7085 3582 5205 7056 7033 6989 5684 6934 4584 1879 6855 936 6810 6772 
1 5 7649 7667 1483 7678 4955 
1 11 7649 3411 7690 865 7749 2177 3641 1876 7930 1406 467 
1 4 7997 8000 8018 8023 
1 34 2818 1680 4178 6113 6130 6140 927 1433 3507 5847 627 1013 820 4436 6203 2615 357 4749 1746 935 6244 6251 6278 6306 872 2700 6344 5019 2955 3387 5567 4268 6444 4649 
1 6 4649 6481 6506 6527 1552 6597 
1 5 7030 1987 7076 7090 7045 
1 66 6597 4576 1927 4578 2073 4843 131 6509 528 4747 5424 1778 6526 1014 88 2774 1244 6558 1445 828 6491 409 6515 972 2497 4875 1577 1122 2395 6592 4939 6609 2379 3676 48 6544 6535 5430 4232 2565 489 3551 6636 4400 6607 3727 1179 3397 4382 5122 6648 196 6687 6700 1290 5827 5711 5687 4180 6709 5103 943 2551 4322 6795 1459 
1 23 3792 6302 1659 298 2852 1289 268 6328 1599 4209 395 4075 2920 5611 908 3325 2647 3677 3068 5307 4387 108 6539 
1 57 4387 243 6518 6486 6473 408 6468 3559 6472 6465 3087 122 6429 5922 34 5053 3093 5842 3938 6396 662 1017 213 503 1513 1530 6374 1620 507 2794 1518 2276 164 1467 1171 1308 2123 2056 6326 919 3905 94 4187 2593 1737 3866 1394 106 3338 3361 1638 1557 6237 4450 75 2380 935 
1 23 919 1426 5723 6352 2031 4094 6405 4733 6420 6423 4947 5123 3416 6507 6526 1132 2786 6587 3659 1531 6676 6699 142 
1 21 5019 3099 831 1899 4857 5921 3579 3372 1091 5160 342 1936 6415 6420 883 348 1694 5957 3542 3913 828 
1 6 1179 5233 1516 1745 815 6429 
2 79 3282 4653 5573 9153 9114 9130 9136 3859 4386 886 3731 9251 4374 9290 3085 9313 4373 9334 4770 5359 3086 1941 9374 9381 1820 3141 9423 9433 4973 9444 3853 9446 4893 5473 5069 9443 1580 9426 5735 54 5276 1806 9347 4214 9354 4261 4976 4821 4532 9407 4506 9416 1855 9419 9431 9445 9452 3030 9466 9468 9462 5058 9479 4859 5267 982 9482 3073 9476 3627 5130 3566 469 9366 3857 9323 3046 2414 4045 
1 3 543 4856 9136 
1 41 9275 9253 9233 144 9169 444 9114 5050 2127 9038 9007 5013 3337 2140 2575 8893 2868 8853 3996 8830 4137 5371 4025 8750 4568 8731 8735 8742 8737 4512 8743 2256 8749 4852 8758 8768 5660 8806 8816 2907 8836 
1 3 9257 9238 3282 
1 10 5947 4373 9314 5894 9293 9288 9250 9222 2485 9195 
1 2 724 1820 
2 49 1855 9393 9380 9375 2557 9346 9339 2495 5320 9311 5673 9287 3770 2622 3226 9191 9192 1150 4257 9142 2643 1775 3067 9139 1008 1992 9117 413 9144 9178 4569 5506 9229 4488 4774 582 2217 2982 9256 4045 9266 4803 9241 2862 3080 9189 9148 5034 3644 
2 26 582 9239 4912 9188 4043 9145 9127 4684 9070 878 1063 4695 8965 8977 783 8998 9014 2855 9015 8999 3316 5174 8966 8951 8937 5806 
1 10 2855 9039 2996 4720 9119 391 9173 9217 9232 9256 
1 2 5350 8951 
1 6 3316 5142 3436 5610 2151 9148 
1 16 9346 9358 9351 9352 9348 3461 9357 2928 2008 9353 1262 5662 710 5830 9279 582 
1 8 5267 1494 5367 9438 1486 9383 2789 9353 
1 11 469 4015 953 18 4168 3610 3789 5644 2461 9190 9148 
1 8 6633 4808 2932 838 6546 4881 487 3540 
2 25 343 201 522 5412 382 8605 628 5815 928 1363 8610 8614 8602 3678 4793 8626 5110 1791 8641 5408 8639 8653 4514 8667 5501 
1 17 8694 8672 841 5323 4501 5532 2976 8618 4780 8613 4555 8596 5434 8625 8645 1515 8642 
1 3 8645 895 8672 
2 50 4639 5504 5216 2222 5291 8695 1120 8696 5556 2449 1370 1983 8722 8729 4966 1970 8756 4344 5531 2003 5880 4357 4362 1645 3342 5753 5453 5104 4269 4083 3584 5016 5060 5651 8931 8945 2985 1918 9036 9042 9053 5183 9050 9051 9047 9054 5206 2087 2936 9043 
2 11 8898 8896 2247 8875 8864 8847 5333 4876 1521 5155 5104 
2 13 1970 8747 8739 2328 8753 826 1922 8754 617 5766 8738 3244 4880 
2 5 2003 8813 8817 1858 8839 
1 33 8159 4902 2561 8222 8246 453 1507 747 8371 3823 8416 8434 8448 3598 8467 8484 4609 4435 2769 8521 5349 8529 8536 8545 1852 1509 8580 8598 5413 1079 8634 8640 4639 
1 31 5291 1600 3767 3707 4000 2681 8540 1300 8522 8514 3432 1907 2688 8523 3738 311 4967 2905 8554 8571 5709 8604 3908 8651 8673 8676 2038 4623 8691 8702 8700 
1 45 3906 8516 4906 4129 1133 8560 1779 5549 8627 8652 8670 8700 4880 8732 673 2466 5335 8790 8810 8823 3049 3548 5081 3278 8898 5105 1616 252 8934 5758 5958 8939 4791 4528 8926 3265 8907 8904 8908 5895 4253 8877 5510 1126 8836 
1 18 8514 5072 4135 8481 172 3367 8456 5552 8431 1503 2397 3095 1637 3055 2814 1033 4024 5834 
1 35 5818 8225 5584 8286 3157 8333 2470 3382 8392 8404 4308 8423 2499 5456 3393 8474 3739 8501 8510 4960 2882 8539 1889 8565 3198 8593 5642 8631 8655 5656 8683 3026 8698 8707 2913 
1 20 8184 5203 2770 3916 8271 5565 1640 1764 5648 4815 747 8360 4582 1514 748 722 8421 4479 8425 8431 
1 17 8595 8609 5389 2869 8604 3890 8588 8578 5363 5328 1590 8542 8547 1133 8548 5841 2951 
1 8 4967 8525 8507 8498 4772 8471 2520 1859 
1 2 4586 8441 
1 17 8839 4467 8841 1644 8819 1080 3467 225 8759 5217 1199 4727 8725 8712 8708 2020 5216 
1 15 8919 5394 5741 8888 8881 451 8882 5752 8883 812 8884 2945 5917 8886 4083 
1 2 8886 4269 
1 8 4083 3193 8921 5539 3496 5481 3275 9085 
1 5 4956 4919 2049 9067 9036 
1 42 8841 1270 8861 8876 5746 3256 8919 956 4604 4500 3126 5252 8987 4314 9030 2250 5186 9059 1544 9085 9076 9112 9099 4495 1106 4956 9143 5857 1180 9149 2385 9159 2455 9156 4412 2581 9106 926 9054 861 8971 5958 
1 12 9043 9032 4424 9072 1958 9122 9137 9160 4558 9212 9224 3282 
1 12 2127 9096 9075 9057 9033 9012 9000 3786 8962 8954 4814 5895 
1 26 4050 8316 1812 8387 8410 4561 8406 3881 2730 5936 8402 396 3154 8336 2733 8307 1637 8283 3544 4463 4931 1822 8254 39 990 8246 
1 8 1417 3410 7235 7253 5824 7211 5210 7143 
1 6 7336 7325 5771 7308 3758 5824 
1 15 4432 4148 7093 4472 829 7210 7237 3843 4752 7345 7375 1209 7411 7455 4419 
1 7 7210 1703 4048 5401 3691 2892 4541 
1 16 3409 2846 7723 938 7726 4073 3408 945 5792 7793 3056 7799 7817 7831 2004 4737 
1 4 7801 412 2447 7894 
1 5 1477 4014 1292 2820 1321 
1 2 5847 2784 
1 3 7667 668 1880 
1 12 3070 4462 7864 1129 1348 7851 2903 3023 644 7699 1813 1434 
1 7 5596 7358 5197 933 1548 5576 868 
1 10 7241 3060 4421 5801 7147 7096 2241 2873 3538 5507 
1 11 2254 6737 3058 6714 3274 5344 3419 6655 6652 6645 4089 
1 5 4938 6872 2025 6836 130 
2 2 2347 837 
1 6 4624 7476 968 7411 4499 2823 
1 11 1957 8125 3097 8096 890 4194 8150 8160 5270 3306 3883 
1 6 890 8082 976 5299 7971 2854 
1 19 2511 3296 2221 2854 7915 2651 7919 7944 7933 7958 1203 1474 8026 8044 4079 2390 8124 8153 2824 
1 5 2909 5014 3105 1953 3709 
1 10 2449 4928 8679 4800 3746 8595 8577 5339 8550 3738 
1 8 8529 345 8517 1596 367 4754 8440 8421 
1 5 3104 560 4262 3402 2814 
1 6 8254 5968 8181 3114 8139 8106 
1 9 4741 7998 4219 4606 1200 7985 2859 7898 1348 
1 6 4848 7573 2293 3530 1434 7568 
1 5 4673 3268 3115 5613 5896 
1 7 3115 16 3281 3858 7359 3934 2494 
1 6 1887 4807 7598 7527 3894 5178 
1 7 5667 7329 7364 3611 7311 7312 7286 
1 4 5913 993 7389 7395 
1 8 4863 7214 7245 5309 7287 2299 7317 5767 
1 7 7182 4674 7122 565 5393 635 7062 
1 5 7072 7062 7038 7006 1526 
1 25 5165 1419 364 3375 7142 578 7208 7236 7258 7280 7304 7338 3181 7397 7421 358 898 7535 7551 5289 7630 3074 7663 4162 7701 
1 5 2787 5639 4099 1355 4159 
1 5 2111 7786 1279 5579 7837 
1 11 7961 4998 1224 4898 5680 7843 4534 3761 2781 7806 7760 
1 6 8257 4225 8180 1345 8114 3202 
1 7 2039 2162 8220 2935 4061 4855 8310 
1 7 8004 2693 3900 8126 2261 2608 5938 
1 3 2261 8158 5098 
1 6 7718 3053 7671 2763 7616 2237 
1 8 7724 1741 4084 5851 214 7544 5316 251 
1 5 4498 3012 2122 7546 4799 
1 6 7383 2790 3931 5082 1675 2122 
1 7 2064 2155 2562 7754 7711 3581 7621 
1 6 7765 7722 5690 2184 155 7711 
1 7 2126 7870 7852 7833 5495 980 2829 
1 3 1512 1747 7833 
1 8 7924 2917 8008 3069 573 5304 680 3402 
1 8 7556 5608 2817 450 4367 5032 7773 7799 
1 3 7587 1088 2817 
1 6 6948 3868 4831 6893 577 6832 
1 5 275 6790 2895 6783 701 
1 5 3948 6990 595 5517 6937 
1 4 2340 599 6871 6861 
1 4 7556 552 5068 7435 
1 4 4291 3622 5599 251 
3 8 7047 498 4489 7129 1471 697 7206 1703 
2 9 7047 5466 2081 6979 4186 120 6854 6821 1628 
2 5 498 2834 1301 3569 4432 
2 4 1471 7152 4549 5312 
3 5 5312 165 2837 4975 1993 
2 4 1078 4672 7061 1993 
1 5 1628 6799 999 6851 6910 
